CREATE ( CarlowKilkenny : constituencies {Name : "Carlow–Kilkenny" })
CREATE ( CavanMonaghan : constituencies {Name : "Cavan–Monaghan" })
CREATE ( Clare : constituencies {Name : "Clare" })
CREATE ( CorkEast : constituencies {Name : "Cork East" })
CREATE ( CorkNorthCentral : constituencies {Name : "Cork North–Central" })
CREATE ( CorkNorthWest : constituencies {Name : "Cork North–West" })
CREATE ( CorkSouthCentral : constituencies {Name : "Cork South–Central" })
CREATE ( CorkSouthWest : constituencies {Name : "Cork South–West" })
CREATE ( Donegal : constituencies {Name : "Donegal" })
CREATE ( DublinBayNorth : constituencies {Name : "Dublin Bay North" })
CREATE ( DublinBaySouth : constituencies {Name : "Dublin Bay South" })
CREATE ( DublinCentral : constituencies {Name : "Dublin Central" })
CREATE ( DublinFingal : constituencies {Name : "Dublin Fingal" })
CREATE ( DublinMidWest : constituencies {Name : "Dublin Mid–West" })
CREATE ( DublinNorthWest : constituencies {Name : "Dublin North–West" })
CREATE ( DublinRathdown : constituencies {Name : "Dublin Rathdown" })
CREATE ( DublinSouthCentral : constituencies {Name : "Dublin South–Central" })
CREATE ( DublinSouthWest : constituencies {Name : "Dublin South–West" })
CREATE ( DublinWest : constituencies {Name : "Dublin West" })
CREATE ( DunLaoghaire : constituencies {Name : "Dún Laoghaire" })
CREATE ( GalwayEast : constituencies {Name : "Galway East" })
CREATE ( GalwayWest : constituencies {Name : "Galway West" })
CREATE ( Kerry : constituencies {Name : "Kerry" })
CREATE ( KildareNorth : constituencies {Name : "Kildare North" })
CREATE ( KildareSouth : constituencies {Name : "Kildare South" })
CREATE ( Laois : constituencies {Name : "Laois" })
CREATE ( LimerickCity : constituencies {Name : "Limerick City" })
CREATE ( LimerickCounty : constituencies {Name : "Limerick County" })
CREATE ( LongfordWestmeath : constituencies {Name : "Longford–Westmeath" })
CREATE ( Louth : constituencies {Name : "Louth" })
CREATE ( Mayo : constituencies {Name : "Mayo" })
CREATE ( MeathEast : constituencies {Name : "Meath East" })
CREATE ( MeathWest : constituencies {Name : "Meath West" })
CREATE ( Offaly : constituencies {Name : "Offaly" })
CREATE ( RoscommonGalway : constituencies {Name : "Roscommon–Galway" })
CREATE ( SligoLeitrim : constituencies {Name : "Sligo–Leitrim" })
CREATE ( Tipperary : constituencies {Name : "Tipperary" })
CREATE ( Waterford : constituencies {Name : "Waterford" })
CREATE ( Wexford : constituencies {Name : "Wexford" })
CREATE ( Wicklow : constituencies {Name : "Wicklow" })

